##.^~****^*~~.~^~..~~~^~.^~.*~**.^^*^*^~..*^^..~^.
*.#~*.~^^^~~.*~*.**.~~^*^**.^~*^^.*^...^..^.**.~^*
^^*##~.*^*^..^**.~~~.~*.~^^~^~^.^~^*~**.~*^.^**.*.
*~~.~#.~*~^~^^*^**.~.*^^*~~^^*~.^.*^^*^.^.~~^^^*~.
*.^~^^#~#.^.^^*~^~~*^..^~^~~^.*^^..**.**~.~~^~*~**
^.^^~^.#~#*.*~*^*~^*~~^.^.~.~^**~.^^^^*.~.~~~^^.^.
*~~.*.^~~~#*.^*~~~*^.^**^*^.^.^~~***^^*^.~^^.^^.~.
.~.*~~^*.**#~^^~**^.^.^~~~^.~.^~~^^.~^^.^^~.~.~.*^
.^^^~~*~.^.~#*~.~~..~*~^.~**~..^****~.*~^~~*~**^~^
^^^*^^**...*.#^*^^^.*~*~^^~*~~.~****~~~~***.^^~~^~
..*^^^^^.^~.^~#^.^^~*~^*~**^*^.~~~*^.^^~**~*~.....
**.^~~~^~*~****#**^~.^.*^^^~.^...~.**^^^^~^.~^~.~*
^*~.*.~*^.~.^^^^#*~.**~^.*^*.~~..^~~~*~*^.~~^*^*^^
~*^.^..**~**^*^~*#*^~~*^*.*~..~^^***^.*~.^*^^^^.~.
*~^~^**^^*^^~^*~^^#~~~*^*~~~~*~^^^*~..~~~~~.*~^~*.
^.*.^*^**^^^~**.*.~#~~~^..~~~*~~^*~..^^.^~*.^~^~**
.***^..*^~~~~^~.*^~~#*.~^.^^*.***^~^.*....~.^.*~^^
^^~~~~.**.*.^^*.^~~^.#..*~*^~*^^.^~~~^*.~^^^~**^~~
^~~*^*.~.*^^^*^.*..~*.#.~**^.^^~.^^.^..^.^**.^^..*
~^***~^.~.~^^^*~~~.*.#^~^^.~^.~.**...~^~**~^~~**^~
~~~^~.^*.^*.~*.*~~^..~#^^~~**.*.*.~^^^..^.~^.*.^~~
^^~...^.*~.^^**~^~*..^~#~*....^.^^**~.*.^^*..~*~.*
^..^...~.~.*.~***~*~~*#.~*~^^~~^~**^~~^*^^~*.~*^*^
*^.**^~*****.~~~..~^~.*#^*~^.^^*^..*~^.^.^*.^.~^^*
~...~*^....*^.*^^*...^#~~..^.*~.*~.*^.^*^*^.****^~
^..~***^.*^~~.****.~*#.~.^~*.~^*^~^.****~..~*..*^~
.~^~**~^^..~~~^..*~*.^#*~..^^*.~.*..*~~*~.^~.~*~~.
.***~..~**^.~.~.~*.~~**#.^.^~..~*~~~~*.**~~^..^.^^
~.*.~^*^*~^.~*..*~^~~.*.#..*.*..^~.*~^^*.~^.^~^**^
.*^~^^*.^*.~*...*~~~*.*#.~...*.*^.^*.^*~*.^~^**^*.
.~..*....~..~.***~..~^#.~~^*^*^~^^~~**^.*~**^**^^*
^.*.~.^.**^*^.~^^*.~..*#~*^***.~**..^.~~*..^*^~*.~
^~~^~~*.~^^~~^**.^.^^^*^#*^^~~.^.*~^*^^..**..**..^
^.^*.*^..*.~~.^^***^.*~#.~.**^*.~^...^^~*.~^~^..~~
~^^.^..*^^.**.~~^*~*^~*~#~~.~*.^~.~*^~*.*..^.^^*^*
^^.~*^~~*.~~*~.^..~*.^.~*#.^*^.^~.**.~*.~...~~..*.
.~..^.~.~.^*.~^*~.~.*^*~~*#^.******~*~~*^~~~^.~~*~
~.*..^^*^~*.~~.~.^~..~.~^^^#*~*.**~^*~*^*^^~..^~^^
*.^*^**^*.^^*....**..~^^~.^*#.*~*^**^^..*.^^*^^^.~
^*^~^^*.~*~^*~^~~.*.^*^~*^^~.#~.*~.**.*~^~~.~*^~~*
~~**~*.^.*~..~~^^^~^^^.~***^*.##~^*~^~*~**...~..~.
*~**^~~.^.*.~^**~*^^.*^*.^~~*~~~#^.*..~~^*^.*^.^.*
.*^~..*~.*^^^^^~~^^*.~*.~~~.***~^#*..~~******~~^*.
.^^..^.^*^~^.~*...**~~~.**^*~~~*^*#*~^*^~^~~^^^*.*
**.**~.**~.*.*^~~.~^.*^.~~*.^*.~.**#~*^^..~*.~*^*^
~..^.****^.****~^~***..^^^^*^.~*^^#.~~.^**^*~^*.~~
^*~^.~*...^^.^~.^^..~^...**...^****#*~*~#^..~^*~.~
...^~^.~^^~~~~.*^~.^~***~~^^^.*^^.~.#*~#~#*^***^~^
.~~~~~^^.~~*^.~^^^**~^~.^~^~*..^*~^^*#.#~#~*##*#^.
~^**.~**..*^~^^^.^*^~^~*^.~*~.^.**.^.^#.~*##~~#~##
